111111111111     
1000000000001  
111110001101 
  100001 1011   
  111011111111111           
    10000000000001    
    1111111000111    
           111    
                      