      1111111
     10010000111
      110000000111
        11000000011
        11000000011
        11000000011
        11000000011
        11000100011
        11001 10011
        11000110011
        11000100011
  1111  11000100011
1100001111000100011
1000000011000100011
1000000011000000011
 11000000000000011
   1111111111111