11111111111111111
10000000000000001
10000000000000001
10000000000000001
10000000000000001
11111111110000001
11111111110000001
11111111110000001
11111111110000001
11111111110000001
11111110000000111
11111000000001111
11000000000000001
10000000000000001
11000000000000001
11000000000000001
11110000000000111
11111000111100111
11111111111111111