111121113211131
300000000000001
200E00031211101
100000001113103
131121311100001
111211133101311
111031000001111
111012000002111
111000000003111
111312000001111
111111111011111
111111121031111
111300000000031
111100000000031
111131123311111