111111111111111
100000000000001
100000001111101
100000001111101
111111111100001
111111111101111
111011000001111
111011000001111
11100000S001111
1111110000011
111111111011111
111111111011111
111100000000011
111100000000011
111111111111111