R 1920 1080

NO ./res/textures/dungeon_wall.xpm
SO ./res/textures/dungeon_wall.xpm
EA ./res/textures/dungeon_wall_cracked.xpm
WE ./res/textures/dungeon_wall_torch.xpm

S ./res/textures/phantom.xpm

C  26, 60, 60
F  135, 64, 9


        1111111111111111111111111
        1000000000110000000000001
        1011000001110222220000001
        1001000000000000000000001
111111111011000001110000000000001
100000000011000001110111110111111
11110111111111011100000010001
11110111111111011101010010201
11000000110101011100000010001
10000000000000001100000010001
10000000000000001101010010001
11000001110101011111011110N0111
11110111 1110101 101111010001
11111111 1111111 111111111111